                                       .*#&&%%%%%%&&%(,                         
                                 /%%* .*//////*******/*,  ,#&%*                 
                             #%/,//////*********,,,,,,,,,,,,//. *&%,            
                          %&,////////********,,,,,,,,,,,,,,,,,,,/(/ *&&         
                       %%///////*/********,,,,,,,,,,,,,,,,,,,,,,*,*/// (&(      
                    #%//////////********,,,,,,,,,,,,,,,,,,,,,,,,,***/////#&(    
                  %#/////////********,,,,,,,,,,,,,,,,,,,,,,,,,,,,,***////(*@&   
               *&(/////////********,,,,,,,,,,,,,,,,,,,,,,,,,,,,******////(((&@  
             /%/(///////********,,,,,,,,,,,,,,,,,,,,,,,,,,,,,*******/////(((&&# 
           *&(////////********,,,,,,,,,,,,,,,,,,,,,,,,,,,,,*********////(((#&@% 
         .%(////////*******,,,,,,,,,,,,,,,,,,,,,,,,,,,,,,,,,,*****/////(((#%@@( 
        &#(//////*******,,,,,,,,,,,,,,,,,,,,,,,,,,,,,,,,,*******//////(((##@@@  
      %%////*.             .,,,,,,,,,,,,,,,,,,,,,,,,,,,,,******//////(((#%@@@*  
    .&,.%&%((/////////(#&&&&%/    .,,,,,,,,,,,,,,,,,,,,*,****//////((((%%@@@/.  
   (&////(####%&&&&&&&&%###(/*/#&&&.   ,,,,,,,,,,,,,,,,******/////(((#%@@@@*,   
  (&(##&&%/*,,*,,,,,,,,,,,/&&&&###*/%&@,  .,,,,,,,,,,,*********/(((##%@@@#*,    
  &&%/**////(#######(/**********/&&&##//&@#  *,****,*********/((/###@@@@**.     
 *&%//(#%&&%#/******/%&&&##/*%&#(/**/&@%#//&@* ************((((###&@@@/*,       
  &&(#&%/%&@&&@@@*/(%&&&%(*(&%(*,&@#(***#@%#/#@% *******/((((#%#%@@@#**         
  %&&%&/@&@@@@@#@&/,,,,,,,*****@%(*,@&(*///%@#/(&,***/((((#%##%@@@#**           
   %&&%&@&&&&%***,,,**/#(&@/*****#&(*,@&/(///#@#/@&(((((#%##%@@@(**             
    *&&&&#(/######%&@@&*******/#@/*@#*,%@*/%#//@#/&%(#####&@@@/*,               
     .**&&&@&#(/*/*/****/(#(#@&&&@**&/,*@(/#%#//@//@%##%&@@&**
        ,**/&@@&@@@&&&&&@@(&@@@@#*/%#//@@//@%(//&/&&#&@@@**.
             ,***********&@@###(%####&@%*///////#&@@@%**.
                          *(@@@@@@@@@@@@@@@&&@@@@@**,
                              ,****,  **********. 
  __   __   U  ___ u   _   _                                _   _          _    
  \ \ / /    \/"_ \/U |"|u| |     __        __     ___     | \ |"|       U|"|u  
   \ V /     | | | | \| |\| |     \"\      /"/    |_"_|   <|  \| |>      \| |/  
  U_|"|_u.-,_| |_| |  | |_| |     /\ \ /\ / /\     | |    U| |\  |u       |_|   
    |_|   \_)-\___/  <<\___/     U  \ V  V /  U  U/| |\u   |_| \_|        (_)   
.-,//|(_       \\   (__) )(      .-,_\ /\ /_,-.-,_|___|_,-.||   \\,-.     |||_  
 \_) (__)     (__)      (__)      \_)-'  '-(_/ \_)-' '-(_/ (_")  (_/     (__)_) 
