###########################
#P# # #         #### # # ## 
# ### #               ### # 
# # ##    ## # ##       ###
#         ####### #  # ####
####### # # ### # # #  # ## 
# # ####### # # #### # #### 
# ###### ## # ###### # C# #
###########################

