########                                                                        
#  P   #                                                                        
#      #                                                                        
#      #                                                                        
#   C  #                                                                        
########