################################
# P           ###  #####       #
#        ## # #### #   ##### # #
#  ###   ## # ## # # # #     # #
# # ## #    # ## # # # # ##### #
# # ## #### # ## #   #   #     #
# # ##    ### ## ####### # #####
# #  ####   # #####      # #   #
# ## #    ### #     # ## # # # #
#      ## ##     #     # #   #C#
################################
